00000100000000000101000000010011
00000100000000000001000000110011
00000100000000000101000000110011
00000110000000000001000000110011
00000110000000000101000000110011
00001000000000000001000000010011
00001000000000000101000000010011
00001000000000000001000000110011
00001000000000000100000000110011
00001000000000000101000000110011
00001000000000000110000000110011
00001000000000000111000000110011
00001010000000000001000000110011
00001010000000000010000000110011
00001010000000000011000000110011
00001010000000000100000000110011
00001010000000000101000000110011
00001010000000000110000000110011
00001010000000000111000000110011
00100000000000000101000000010011
00100000000000000001000000010011
00100000000000000001000000110011
00100000000000000010000000110011
00100000000000000100000000110011
00100000000000000101000000110011
00100000000000000110000000110011
00101000000000000101000000010011
00101000000000000001000000010011
00101000000000000001000000110011
00101000000000000101000000110011
01000000000000000100000000110011
01000000000000000110000000110011
01000000000000000111000000110011
01001000000000000001000000010011
01001000000000000101000000010011
01001000000000000001000000110011
01001000000000000100000000110011
01001000000000000101000000110011
01001000000000000110000000110011
01001000000000000111000000110011
01100000000000000101000000010011
01100000000000000001000000110011
01100000000000000101000000110011
01100000000000000001000000010011
01100000000100000001000000010011
01100000001000000001000000010011
01100000010000000001000000010011
01100000010100000001000000010011
01100001000000000001000000010011
01100001000100000001000000010011
01100001001000000001000000010011
01100001100000000001000000010011
01100001100100000001000000010011
01100001101000000001000000010011
01101000000000000101000000010011
01101000000000000001000000010011
01101000000000000001000000110011
01101000000000000101000000110011
