0x4005013
0x4001033
0x4005033
0x6001033
0x6005033
0x8001013
0x8005013
0x8001033
0x8004033
0x8005033
0x8006033
0x8007033
0xa001033
0xa002033
0xa003033
0xa004033
0xa005033
0xa006033
0xa007033
0x20005013
0x20001013
0x20001033
0x20002033
0x20004033
0x20005033
0x20006033
0x28005013
0x28001013
0x28001033
0x28005033
0x40004033
0x40006033
0x40007033
0x48001013
0x48005013
0x48001033
0x48004033
0x48005033
0x48006033
0x48007033
0x60005013
0x60001033
0x60005033
0x60001013
0x60101013
0x60201013
0x60401013
0x60501013
0x61001013
0x61101013
0x61201013
0x61801013
0x61901013
0x61a01013
0x68005013
0x68001013
0x68001033
0x68005033
